################################
#.............*##*.............#
#.######.#####.##.#####.######.#
#$#....#.#...#.##.#...#.#....#$#
#.######.#####.##.#####.######.#
#..............................#
#.######.##.########.##.######.#
#.######.##.########.##.######.#
#*......*##*...##...*##*......*#
########.#####.##.#####.########
########.#####.##.#####.########
########.##..........##.########
########.##.########.##.########
#........##.#......#.##........#
#*######*...#......#...*######*#
#........##.#......#.##........#
########.##.########.##.########
########.##..........##.########
########.##.########.##.########
########.##.########.##.########
#.......*.....*##*.....*.......#
#.######.#####.##.#####.######.#
#.######.#####.##.#####.######.#
#*....##................##....*#
#####.##.##.########.##.##.#####
#####.##.##.########.##.##.#####
#........##*...##...*##........#
#.############.##.############.#
#$#..........#.##.#..........#$#
#.############.##.############.#
#......*.................*.....#
################################